2 22 4323 616 6785 6802 6818 3124 6861 6889 358 3515 792 6966 1600 7030 7062 3798 7101 5453 1152 4157 7233 4617 
1 4 6966 1778 4700 6980 
1 5 4984 2739 76 6043 4297 
1 7 4297 6021 5997 5983 3533 3361 1863 
1 9 4297 4931 200 3432 4010 2945 4039 6058 1100 
1 6 4297 6092 3884 6143 6172 1781 
1 3 4620 1781 4774 
1 16 6980 5451 4431 296 6926 3186 5031 726 2843 4476 6898 437 3494 4930 2147 4006 
1 6 4006 6800 6760 6750 708 4628 
1 12 4628 2483 2180 3114 6720 2318 549 6708 573 4447 1437 6610 
1 3 5094 2365 3125 
1 5 3125 2375 2211 6276 6252 
1 4 6252 4061 6247 4710 
1 4 4710 2092 2694 6235 
1 9 6235 4685 4427 4704 5437 1757 6159 6130 557 
1 5 5853 5827 5792 5778 2768 
1 6 5853 5858 3732 1440 5872 3861 
1 7 1088 6022 2169 1888 6024 3292 4468 
1 2 4468 1100 
1 5 6966 3773 6967 5362 5428 
1 4 7233 3387 7241 7230 
1 6 7230 4991 7284 1338 7318 7323 
1 5 7230 7238 4347 1143 4994 
1 6 4994 3629 7250 676 4162 7245 
1 5 557 1404 6078 5226 6022 
1 5 1863 5893 3298 4572 2119 
1 5 2897 6038 1472 4879 5179 
1 7 5179 1312 84 4336 1457 3065 4984 
1 9 84 1943 3458 1661 2895 447 1590 1304 4620 
1 7 4984 6004 5989 1242 4211 1234 2119 
1 7 2897 1968 3469 2533 578 4295 6152 
1 5 2897 5257 5984 5310 1458 
1 9 5984 3031 3752 4564 4651 4544 6047 436 6090 
1 9 1590 3657 2252 4341 3618 6292 311 5162 1831 
1 3 1831 1808 3026 
1 8 1312 3615 5242 3874 6226 5107 6300 311 
1 6 1458 759 4148 149 906 5783 
1 8 5179 2951 3098 5991 5962 5938 4667 5919 
1 4 5919 2360 5923 4211 
1 4 5938 5911 5895 4148 
1 6 2119 2756 5822 3013 2639 4330 
1 8 5783 2144 3937 5705 961 2417 502 5648 
1 10 502 3667 1370 4426 5634 2559 5616 636 5080 3300 
1 4 3300 2724 2041 4434 
1 5 4434 2447 2261 2294 306 
1 6 306 5438 2121 4055 2020 3468 
1 6 4055 5660 4500 1350 3279 4824 
1 10 4330 5762 2470 5713 2953 3270 1918 2777 5400 306 
1 4 5762 934 514 4742 
1 9 3468 5712 767 1236 1719 5826 5857 1869 5886 
1 3 5886 1851 2466 
1 6 4742 3687 2774 4896 4612 1719 
1 6 4774 4449 3202 6324 719 6348 
1 6 573 5510 1807 2516 4869 925 
1 5 925 2544 356 6756 1124 
1 6 1124 3680 6711 2416 3708 6677 
1 4 6677 4237 6614 5485 
1 7 5485 3532 4231 2952 3649 6542 392 
1 4 392 4923 5530 1203 
1 6 5485 6564 4906 640 6527 4560 
1 7 640 4743 1905 4942 6433 4072 1831 
1 6 640 1290 2176 709 1741 2031 
1 3 2031 2868 6348 
1 4 4323 2311 2402 6851 
1 8 6851 5198 5301 5424 6860 6872 6899 3972 
1 8 5094 3538 6349 6326 2596 6280 1190 2769 
1 4 2769 4462 1425 2540 
1 5 2540 5524 3552 6113 1391 
1 9 1391 1892 6064 6044 6015 3816 3543 4584 1452 
1 10 1452 700 2526 965 5780 5106 5768 3004 5069 2768 
1 5 3004 1725 4048 2575 5655 
1 8 2575 3467 4466 67 860 4748 704 4657 
1 6 4657 2826 2464 4047 3940 5658 
1 7 2464 5763 3392 5806 4959 2070 5040 
1 6 5040 4874 5517 1774 6062 4753 
1 7 4753 5287 1611 4977 2840 6240 1190 
1 6 4824 3043 5661 5673 2383 5658 
1 6 3125 2892 6400 1406 5439 6387 
1 9 5094 6419 3414 4621 4103 6528 943 495 5053 
1 5 5053 6602 3230 6634 5046 
1 8 5046 6694 4307 4227 3576 4311 1840 2147 
1 8 4476 6874 2373 6825 4208 2983 6771 3517 
1 18 3517 2066 6697 2888 848 6642 3923 591 1910 2370 6538 2436 6499 6481 6469 3335 2202 5094 
1 7 6481 3658 1819 6460 4314 1146 4266 
1 11 4704 6251 3919 6305 2021 2738 6386 3091 6431 1209 1203 
1 5 5046 825 6639 6626 3923 
1 16 495 4796 3594 2700 3260 4591 58 869 4066 3203 292 4614 6653 6672 1604 6720 
1 11 1124 3005 3460 6844 4803 3428 6916 2250 2315 6960 6977 
1 6 6977 2539 7055 3219 1072 614 
1 6 4803 3252 3868 6869 6876 6885 
1 7 3868 6907 3637 1418 6968 3144 7018 
1 8 7018 7046 3992 4672 4717 1364 4988 5041 
1 8 6977 3017 1219 4285 7041 7061 3757 7081 
1 5 7081 5497 3622 4212 3290 
1 8 3622 2550 5434 7089 2529 7042 3837 6996 
1 5 6996 2615 3023 7059 5038 
1 5 6996 4086 594 6935 6913 
1 10 5038 7090 3991 3769 7085 7082 7093 3284 3226 7111 
1 5 7111 7138 3357 4678 7245 
1 6 7111 7107 7094 4172 7071 620 
1 6 620 7067 681 2878 7003 6980 
1 7 620 4392 7139 826 4752 1516 7230 
1 4 7245 7248 2594 7305 
1 7 7245 7216 1049 7227 5309 1361 7286 
1 7 7286 1868 888 4969 1226 7226 7201 
1 5 7201 2935 2511 3536 5038 
1 6 5428 2967 6927 1797 1995 6851 
1 8 5428 6962 6972 3258 7015 1916 3396 3824 
1 13 3972 4594 6875 6863 3910 4229 4814 6880 6884 1931 3426 6862 4677 
1 7 3972 5189 4260 1251 6955 1973 7015 
1 11 3824 7051 4859 7020 4862 1228 2548 7009 1305 2091 5480 
1 7 4677 2083 97 740 3651 6992 5480 
1 4 4677 254 4828 6775 
1 8 6775 4823 4096 1877 6651 5163 2512 2709 
1 3 2709 663 1873 
1 6 2709 6568 2349 2578 6530 2175 
1 7 1873 5295 4822 371 1042 3553 6374 
1 6 6374 2956 3324 1575 6253 3810 
1 6 3324 6313 6289 675 5055 73 
1 4 73 2074 605 4669 
1 10 5090 2714 6188 4429 355 6150 861 1854 4038 179 
1 7 5090 6237 3348 4195 3416 6204 6215 
1 5 6215 2798 6151 1277 5535 
1 9 1277 1627 1928 6119 4535 1297 3639 4958 2580 
1 5 2580 6345 6334 237 5190 
1 10 2580 4180 485 3931 526 6473 1635 3668 3034 4627 
1 5 4627 4471 1599 3621 6530 
1 15 4627 1321 6572 631 1762 2099 2106 5432 363 6864 744 3227 2215 6896 4677 
1 5 5535 1904 5338 1445 2258 
1 6 2258 1108 1989 4246 3666 3853 
1 6 675 6261 628 4146 3291 1325 
1 7 179 2799 951 6100 4127 2103 1325 
1 6 2103 6065 3748 3475 3934 2367 
1 7 2768 4383 4711 5735 4996 1274 3254 
1 9 3861 2152 1963 5875 2908 2963 4215 655 5824 
1 6 3254 5307 5790 4281 5838 2908 
1 9 4753 3156 4976 5361 6163 2310 2600 6227 6252 
1 14 6916 6909 1215 4416 388 1275 3229 4663 6832 4665 5116 583 3954 6720 
1 7 925 4450 6625 6601 6576 3183 392 
1 5 5530 6456 3827 4372 2031 
1 4 4323 1365 5003 1926 
1 4 4359 2081 7402 7391 
1 9 7391 1678 5171 962 2012 3855 327 4169 7323 
1 8 4359 7417 2848 2415 7467 2313 2384 7522 
1 15 7323 3405 4069 1468 7381 3983 4142 4470 3993 7406 3477 7410 1922 4574 4126 
1 16 4142 2626 7441 163 5534 2323 4401 2010 1872 7536 3431 7553 4161 3713 4618 4423 
1 9 7522 7515 2753 5462 7538 2328 1169 7550 4161 
1 7 1872 3071 2699 1601 3587 7529 7525 
1 8 7525 2085 4001 7567 995 2037 7608 2647 
1 18 7525 7519 4505 7507 1112 7499 5111 2860 7487 3038 2413 2143 7452 1113 4174 5216 702 2172 
1 6 3587 7556 1235 5505 2800 489 
1 17 489 2649 5143 4915 660 4782 5213 7631 1935 7641 4985 245 7646 2253 7645 915 1248 
1 7 4423 7560 3580 5399 7575 1332 4849 
1 8 4849 7596 4463 7616 7623 7630 7640 1248 
1 11 7623 4800 2558 7633 4898 5229 3117 7652 7660 5391 491 
1 8 1248 3753 4997 5321 512 5157 5151 7678 
1 5 7678 7689 3951 4735 7695 
1 12 7600 7587 4644 7559 3555 7530 3463 7504 4583 3406 7461 2172 
1 11 1452 343 5913 3568 5952 673 4098 2786 5898 5877 3732 
1 8 5824 4075 4947 126 5729 3846 5740 3853 
1 10 6348 6321 6301 6257 1422 1866 2016 3410 2460 4704 
1 6 1422 2670 1565 3105 2201 2945 
