2 22 4323 616 6785 6802 6818 3124 6861 6889 358 3515 792 6966 1600 7030 7062 3798 7101 5453 1152 4157 7233 4617 
1 4 6966 1778 4700 6980 
1 5 4984 2739 76 6043 4297 
1 7 4297 6021 5997 5983 3533 3361 1863 
1 9 4297 4931 200 3432 4010 2945 4039 6058 1100 
1 6 4297 6092 3884 6143 6172 1781 
1 3 4620 1781 4774 
1 16 6980 5451 4431 296 6926 3186 5031 726 2843 4476 6898 437 3494 4930 2147 4006 
1 6 4006 6800 6760 6750 708 4628 
1 12 4628 2483 2180 3114 6720 2318 549 6708 573 4447 1437 6610 
1 3 5094 2365 3125 
1 5 3125 2375 2211 6276 6252 
1 4 6252 4061 6247 4710 
1 4 4710 2092 2694 6235 
1 9 6235 4685 4427 4704 5437 1757 6159 6130 557 
1 5 5853 5827 5792 5778 2768 
1 6 5853 5858 3732 1440 5872 3861 
1 7 1088 6022 2169 1888 6024 3292 4468 
1 2 4468 1100 
1 5 6966 3773 6967 5362 5428 
1 4 7233 3387 7241 7230 
1 6 7230 4991 7284 1338 7318 7323 
1 5 7230 7238 4347 1143 4994 
1 6 4994 3629 7250 676 4162 7245 
1 5 557 1404 6078 5226 6022 
1 5 1863 5893 3298 4572 2119 
1 5 2897 6038 1472 4879 5179 
1 7 5179 1312 84 4336 1457 3065 4984 
1 9 84 1943 3458 1661 2895 447 1590 1304 4620 
1 7 4984 6004 5989 1242 4211 1234 2119 
1 7 2897 1968 3469 2533 578 4295 6152 
1 5 2897 5257 5984 5310 1458 
1 9 5984 3031 3752 4564 4651 4544 6047 436 6090 
1 9 1590 3657 2252 4341 3618 6292 311 5162 1831 
1 3 1831 1808 3026 
1 8 1312 3615 5242 3874 6226 5107 6300 311 
1 6 1458 759 4148 149 906 5783 
1 8 5179 2951 3098 5991 5962 5938 4667 5919 
1 4 5919 2360 5923 4211 
1 4 5938 5911 5895 4148 
1 6 2119 2756 5822 3013 2639 4330 
1 8 5783 2144 3937 5705 961 2417 502 5648 
1 10 502 3667 1370 4426 5634 2559 5616 636 5080 3300 
1 4 3300 2724 2041 4434 
1 5 4434 2447 2261 2294 306 
1 6 306 5438 2121 4055 2020 3468 
1 6 4055 5660 4500 1350 3279 4824 
1 10 4330 5762 2470 5713 2953 3270 1918 2777 5400 306 
1 4 5762 934 514 4742 
1 9 3468 5712 767 1236 1719 5826 5857 1869 5886 
1 3 5886 1851 2466 
1 6 4742 3687 2774 4896 4612 1719 
1 6 4774 4449 3202 6324 719 6348 
1 6 573 5510 1807 2516 4869 925 
1 5 925 2544 356 6756 1124 
1 6 1124 3680 6711 2416 3708 6677 
1 4 6677 4237 6614 5485 
1 7 5485 3532 4231 2952 3649 6542 392 
1 4 392 4923 5530 1203 
1 6 5485 6564 4906 640 6527 4560 
1 7 640 4743 1905 4942 6433 4072 1831 
1 6 640 1290 2176 709 1741 2031 
1 3 2031 2868 6348 
1 4 4323 2311 2402 6851 
1 8 6851 5198 5301 5424 6860 6872 6899 3972 
